10 8
6 5
3  1  4 -1 -1  8  8  8  0  0
3  3  2  6  2  3  8  8  1  0
3  3  3  5  6  8 10  6  1  0
0  1  1  4  0 10 10 -1  1  0
0  1  1  4  5  0  0 -1  1  0
0  1  1  1  1  0  0 -1  1  0
0  1  1  1  1  1 10 10  3  0
0  0  0  0  0  0 10 10 10  0